1111111111111111111111111111111111
1E0000000000000C00000F000R00000001
1110010100100000101001000000010101
1010010010101010001001000000010101
1010010100100000101001000000010101
10100100101010100010010000R0010101
1010010100100000101001000000010101
1010010010101010001001000000010101
1010010100100C00101001000000010101
1010010010101010001001000000010111
1000P0000C00C00000R0000000001R00C1
1111111111111111111111111111111111