1111111111111111111111
1000CC1111111100000001
1000CC1111111100000001
11001CCC00001110000001
11001CCC00001110000001
1100100000CC0000100001
1100100000CC0000000001
1100111000001111C11111
11P0111000001111C11111
1111111000001111C11111
1CCCCCCC11111111111111
1000000000C00001111111
111000000CC11000111111
11100C0011110000011111
1E00C00011100000011111
1110CC1111111100011111
1000CC1111111100000001
10001CCC00001110000001
10001CCC00001110000001
100010000CCC0000100001
1000100000CC0000100001
1000111000001111C00011
1000111000001111C00111
1000111000001111C01101
1111111CCCCCCCCCC11001
1CC0000000CC0001110001
111000000CC11111100001
1111111111111111111111